{
  
  "mapHeight": 15,
  "mapWidth": 80,
  "tileMap": [
    [ 4, 5, 5, 5, 5, 5, 5, 5, 5, 5, 5, 5, 5, 5, 7 ],
    [ 2, 3, 3, 3, 3, 3, 3, 9, 9, 9, 9, 9, 9, 9, 8 ],
    [ 20, 20, 20, 20, 19, 16, 16, 1, 9, 9, 9, 9, 9, 9, 8 ],
    [ 20, 20, 20, 20, 19, 16, 16, 1, 9, 9, 9, 9, 9, 9, 8 ],
    [ 20, 20, 20, 20, 19, 16, 16, 1, 9, 9, 9, 9, 9, 9, 8 ],
    [ 20, 20, 20, 20, 19, 16, 16, 1, 9, 9, 9, 9, 9, 9, 8 ],
    [ 20, 20, 20, 20, 19, 16, 16, 2, 9, 9, 9, 9, 9, 9, 8 ],
    [ 20, 20, 20, 20, 19, 16, 16, 16, 1, 9, 9, 9, 9, 9, 8 ],
    [ 20, 20, 20, 20, 19, 16, 16, 16, 1, 9, 9, 9, 3, 3, 6 ],
    [ 20, 20, 20, 20, 19, 16, 16, 16, 1, 9, 9, 8, 15, 14, 4 ],
    [ 20, 20, 20, 20, 19, 16, 16, 16, 1, 9, 9, 8, 15, 14, 1 ],
    [ 20, 20, 20, 20, 19, 16, 16, 16, 2, 3, 3, 6, 15, 14, 1 ],
    [ 20, 20, 20, 20, 19, 16, 16, 16, 16, 16, 16, 16, 15, 14, 1 ],
    [ 20, 20, 20, 20, 19, 16, 16, 16, 16, 16, 16, 16, 15, 14, 1 ],
    [ 20, 20, 20, 20, 19, 16, 16, 16, 16, 16, 1, 16, 15, 14, 1 ],
    [ 20, 20, 20, 20, 19, 16, 16, 16, 16, 16, 1, 16, 15, 14, 1 ],
    [ 9, 3, 3, 9, 19, 16, 16, 16, 16, 16, 1, 16, 15, 14, 1 ],
    [ 8, 20, 20, 1, 19, 16, 16, 16, 16, 16, 2, 16, 15, 14, 1 ],
    [ 8, 20, 20, 1, 19, 16, 16, 16, 16, 16, 16, 16, 15, 14, 1 ],
    [ 8, 20, 20, 1, 19, 16, 16, 16, 16, 16, 16, 16, 15, 4, 9 ],
    [ 8, 20, 20, 1, 19, 16, 16, 16, 16, 16, 16, 16, 15, 1, 9 ],
    [ 8, 20, 20, 1, 19, 16, 16, 16, 16, 16, 16, 16, 15, 1, 9 ],
    [ 8, 20, 20, 1, 19, 16, 16, 16, 16, 16, 16, 16, 15, 2, 3 ],
    [ 8, 20, 20, 1, 19, 16, 16, 16, 16, 16, 16, 16, 15, 14, 14 ],
    [ 8, 0, 0, 1, 19, 16, 16, 16, 16, 16, 16, 16, 15, 14, 14 ],
    [ 6, 20, 20, 2, 19, 16, 16, 16, 16, 16, 16, 16, 15, 14, 14 ],
    [ 20, 20, 20, 20, 19, 16, 16, 16, 16, 16, 16, 16, 4, 5, 7 ],
    [ 20, 20, 20, 20, 19, 16, 16, 16, 16, 16, 16, 16, 1, 9, 8 ],
    [ 20, 20, 20, 20, 19, 16, 16, 16, 16, 16, 16, 16, 2, 3, 6 ],
    [ 20, 20, 1, 20, 19, 16, 16, 16, 16, 16, 16, 16, 15, 14, 14 ],
    [ 20, 20, 1, 20, 19, 16, 16, 16, 16, 16, 16, 16, 15, 14, 14 ],
    [ 20, 20, 1, 20, 19, 16, 16, 16, 16, 16, 16, 16, 15, 14, 14 ],
    [ 7, 20, 1, 20, 19, 16, 16, 16, 16, 16, 16, 4, 15, 14, 4 ],
    [ 8, 0, 1, 20, 19, 16, 16, 16, 16, 16, 16, 1, 15, 14, 1 ],
    [ 8, 20, 20, 20, 19, 16, 16, 16, 16, 16, 16, 2, 15, 14, 2 ],
    [ 8, 20, 20, 1, 19, 16, 16, 16, 16, 16, 16, 16, 15, 14, 14 ],
    [ 8, 20, 20, 1, 19, 16, 16, 16, 16, 16, 16, 16, 15, 14, 14 ],
    [ 6, 20, 20, 1, 19, 16, 16, 16, 16, 16, 16, 16, 15, 14, 14 ],
    [ 20, 20, 20, 1, 19, 16, 16, 16, 16, 16, 16, 16, 15, 14, 14 ],
    [ 20, 20, 20, 1, 19, 16, 16, 16, 16, 16, 16, 16, 15, 4, 7 ],
    [ 20, 20, 20, 20, 19, 16, 16, 16, 16, 16, 16, 16, 15, 2, 6 ],
    [ 20, 20, 20, 20, 19, 16, 16, 16, 16, 16, 16, 16, 15, 14, 14 ],
    [ 20, 20, 20, 20, 1, 16, 16, 16, 16, 16, 16, 16, 15, 14, 14 ],
    [ 20, 20, 20, 20, 19, 16, 16, 16, 16, 16, 16, 16, 15, 14, 14 ],
    [ 20, 20, 20, 20, 19, 16, 16, 16, 16, 16, 16, 4, 5, 5, 7 ],
    [ 20, 20, 20, 20, 19, 16, 16, 16, 16, 16, 16, 1, 9, 9, 8 ],
    [ 20, 20, 20, 20, 19, 16, 16, 16, 16, 16, 16, 2, 3, 3, 6 ],
    [ 20, 20, 20, 20, 19, 16, 16, 16, 16, 16, 16, 16, 15, 14, 14 ],
    [ 20, 1, 20, 20, 19, 16, 16, 16, 16, 16, 16, 16, 15, 14, 14 ],
    [ 20, 20, 20, 20, 19, 16, 16, 16, 16, 16, 16, 16, 15, 14, 14 ],
    [ 20, 20, 20, 20, 19, 16, 16, 16, 16, 16, 16, 16, 15, 14, 14 ],
    [ 20, 20, 20, 20, 19, 16, 16, 16, 16, 16, 16, 16, 15, 14, 14 ],
    [ 20, 20, 20, 20, 19, 16, 16, 16, 16, 4, 7, 16, 15, 4, 7 ],
    [ 20, 20, 20, 20, 19, 16, 16, 16, 16, 1, 8, 16, 15, 1, 8 ],
    [ 20, 20, 1, 9, 9, 9, 9, 16, 16, 1, 8, 16, 15, 1, 8 ],
    [ 20, 20, 20, 20, 19, 16, 16, 16, 16, 1, 8, 16, 15, 1, 8 ],
    [ 20, 20, 20, 20, 19, 16, 16, 16, 16, 1, 8, 16, 15, 1, 8 ],
    [ 20, 20, 20, 20, 19, 16, 16, 16, 4, 9, 8, 16, 15, 1, 8 ],
    [ 20, 20, 20, 20, 19, 16, 16, 16, 1, 9, 8, 16, 15, 1, 8 ],
    [ 20, 20, 20, 20, 19, 16, 16, 16, 2, 3, 6, 16, 15, 2, 6 ],
    [ 20, 20, 1, 20, 19, 16, 16, 16, 16, 16, 16, 16, 15, 14, 4 ],
    [ 20, 20, 1, 20, 19, 16, 16, 16, 16, 16, 16, 16, 15, 14, 1 ],
    [ 20, 20, 1, 20, 19, 16, 16, 16, 16, 16, 16, 16, 15, 14, 1 ],
    [ 20, 1, 20, 20, 19, 16, 4, 7, 16, 16, 16, 16, 15, 14, 1 ],
    [ 20, 1, 20, 20, 19, 16, 1, 8, 16, 16, 16, 16, 15, 14, 1 ],
    [ 20, 1, 20, 20, 19, 16, 2, 16, 16, 16, 16, 16, 15, 14, 2 ],
    [ 20, 1, 20, 20, 19, 16, 16, 16, 16, 16, 16, 4, 5, 5, 7 ],
    [ 20, 1, 20, 20, 19, 16, 16, 16, 16, 16, 16, 1, 9, 9, 8 ],
    [ 20, 1, 20, 20, 19, 16, 16, 16, 16, 16, 16, 1, 9, 9, 8 ],
    [ 20, 20, 20, 20, 19, 16, 16, 16, 16, 16, 16, 1, 9, 9, 8 ],
    [ 20, 20, 20, 20, 19, 16, 16, 16, 16, 16, 16, 2, 3, 3, 6 ],
    [ 8, 20, 20, 1, 19, 16, 16, 16, 16, 16, 16, 16, 15, 14, 14 ],
    [ 8, 20, 20, 1, 19, 16, 16, 16, 16, 16, 16, 16, 15, 14, 14 ],
    [ 8, 20, 20, 20, 1, 16, 16, 16, 16, 16, 16, 16, 15, 14, 14 ],
    [ 8, 20, 20, 20, 1, 16, 16, 16, 16, 1, 16, 16, 15, 14, 14 ],
    [ 8, 20, 20, 20, 1, 16, 16, 16, 16, 1, 16, 16, 15, 14, 14 ],
    [ 8, 20, 20, 20, 19, 16, 16, 16, 16, 1, 16, 16, 15, 14, 14 ],
    [ 8, 20, 20, 20, 19, 16, 16, 16, 16, 16, 16, 16, 15, 14, 14 ],
    [ 8, 20, 20, 20, 19, 16, 4, 7, 16, 16, 16, 16, 15, 14, 14 ],
    [ 6, 20, 20, 20, 19, 16, 2, 6, 16, 16, 16, 16, 15, 14, 14 ]
  ],
  "entityMap": [
    [ 0, 0, 0, 0, 0, 0, 0, 0, 0, 0, 0, 0, 0, 0, 0 ],
    [ 0, 0, 0, 0, 0, 0, 0, 0, 0, 0, 0, 0, 0, 0, 0 ],
    [ 0, 0, 0, 0, 0, 0, 0, 0, 0, 0, 0, 0, 0, 0, 0 ],
    [ 0, 0, 0, 1, 0, 0, 0, 0, 0, 0, 0, 0, 0, 0, 0 ],
    [ 0, 0, 0, 0, 0, 0, 0, 0, 0, 0, 0, 0, 0, 0, 0 ],
    [ 0, 0, 0, 0, 0, 0, 0, 0, 0, 0, 0, 0, 0, 0, 0 ],
    [ 0, 0, 0, 0, 0, 0, 0, 0, 0, 0, 0, 0, 0, 0, 0 ],
    [ 0, 0, 0, 0, 0, 0, 0, 0, 0, 0, 0, 0, 0, 0, 0 ],
    [ 0, 0, 0, 0, 0, 0, 0, 0, 0, 0, 0, 0, 0, 0, 0 ],
    [ 0, 0, 0, 0, 0, 0, 0, 11, 0, 0, 0, 0, 0, 10, 0 ],
    [ 0, 0, 0, 0, 0, 0, 0, 0, 0, 0, 0, 0, 0, 0, 0 ],
    [ 0, 0, 0, 0, 0, 0, 0, 0, 0, 0, 0, 0, 16, 16, 0 ],
    [ 0, 0, 0, 0, 0, 0, 0, 0, 0, 0, 0, 0, 0, 0, 0 ],
    [ 0, 0, 0, 0, 0, 0, 0, 0, 0, 0, 0, 7, 0, 0, 0 ],
    [ 0, 0, 0, 0, 0, 0, 0, 0, 0, 0, 0, 0, 0, 0, 0 ],
    [ 0, 0, 0, 0, 0, 0, 0, 0, 0, 0, 0, 0, 0, 0, 0 ],
    [ 0, 0, 0, 0, 0, 0, 0, 0, 0, 0, 0, 0, 0, 0, 0 ],
    [ 0, 0, 0, 0, 0, 0, 0, 0, 0, 0, 0, 0, 0, 0, 0 ],
    [ 0, 0, 2, 0, 0, 0, 0, 0, 0, 0, 0, 0, 0, 0, 0 ],
    [ 0, 0, 0, 0, 0, 0, 0, 0, 0, 0, 0, 0, 0, 0, 0 ],
    [ 0, 0, 0, 0, 0, 0, 0, 0, 0, 0, 0, 0, 0, 0, 0 ],
    [ 0, 0, 0, 0, 0, 0, 0, 0, 0, 0, 0, 0, 9, 0, 0 ],
    [ 0, 0, 10, 0, 0, 0, 0, 0, 0, 0, 0, 0, 0, 0, 0 ],
    [ 0, 0, 0, 0, 0, 0, 0, 0, 0, 0, 0, 0, 0, 0, 0 ],
    [ 0, 14, 14, 0, 0, 0, 0, 0, 0, 0, 0, 0, 0, 0, 0 ],
    [ 0, 0, 0, 0, 0, 0, 0, 0, 0, 0, 0, 0, 0, 0, 0 ],
    [ 0, 0, 0, 0, 0, 0, 0, 0, 0, 0, 0, 17, 0, 0, 0 ],
    [ 0, 0, 0, 0, 0, 0, 0, 0, 0, 0, 0, 0, 0, 0, 0 ],
    [ 0, 0, 0, 0, 0, 0, 0, 0, 0, 0, 0, 0, 0, 0, 0 ],
    [ 0, 0, 0, 0, 0, 0, 0, 0, 0, 0, 0, 0, 0, 0, 0 ],
    [ 0, 0, 0, 0, 0, 0, 0, 0, 0, 0, 0, 0, 0, 0, 0 ],
    [ 0, 10, 0, 0, 0, 0, 0, 0, 0, 0, 0, 0, 0, 0, 0 ],
    [ 0, 0, 0, 0, 0, 0, 0, 0, 0, 0, 0, 0, 0, 0, 0 ],
    [ 0, 15, 0, 0, 0, 0, 0, 0, 5, 0, 0, 0, 0, 10, 0 ],
    [ 0, 0, 0, 0, 0, 0, 0, 0, 0, 0, 0, 0, 0, 0, 0 ],
    [ 0, 0, 0, 0, 0, 0, 0, 0, 0, 0, 0, 0, 0, 0, 0 ],
    [ 0, 0, 0, 0, 0, 0, 0, 0, 0, 0, 0, 0, 0, 0, 0 ],
    [ 0, 0, 0, 0, 0, 0, 0, 0, 0, 0, 0, 0, 0, 0, 0 ],
    [ 0, 0, 18, 0, 0, 0, 0, 0, 0, 0, 0, 0, 0, 0, 0 ],
    [ 0, 0, 0, 0, 0, 0, 0, 0, 0, 0, 0, 0, 11, 0, 0 ],
    [ 0, 0, 0, 0, 0, 0, 0, 0, 0, 0, 0, 0, 0, 0, 0 ],
    [ 0, 0, 0, 0, 0, 0, 0, 0, 0, 0, 0, 0, 0, 0, 0 ],
    [ 0, 0, 0, 11, 0, 0, 0, 0, 0, 0, 0, 0, 0, 0, 0 ],
    [ 0, 0, 0, 0, 0, 0, 0, 0, 0, 0, 0, 0, 0, 0, 0 ],
    [ 0, 0, 0, 0, 0, 0, 0, 0, 0, 0, 0, 0, 0, 0, 0 ],
    [ 0, 0, 0, 0, 0, 0, 0, 0, 0, 0, 17, 0, 0, 0, 0 ],
    [ 0, 0, 0, 0, 0, 0, 0, 0, 0, 0, 9, 0, 0, 0, 0 ],
    [ 0, 0, 0, 0, 0, 0, 0, 0, 0, 0, 0, 0, 0, 0, 0 ],
    [ 12, 0, 0, 0, 0, 0, 0, 0, 0, 0, 0, 0, 0, 0, 0 ],
    [ 0, 0, 0, 0, 0, 0, 0, 0, 0, 0, 0, 0, 0, 0, 0 ],
    [ 0, 0, 0, 0, 0, 0, 0, 0, 0, 0, 0, 0, 0, 0, 0 ],
    [ 0, 0, 0, 0, 0, 0, 0, 0, 0, 0, 0, 0, 0, 0, 0 ],
    [ 0, 0, 0, 0, 0, 0, 0, 0, 0, 0, 0, 0, 0, 0, 0 ],
    [ 0, 0, 0, 0, 0, 0, 0, 0, 0, 0, 0, 0, 0, 0, 0 ],
    [ 0, 0, 0, 0, 0, 0, 0, 15, 15, 0, 0, 14, 14, 0, 0 ],
    [ 0, 0, 0, 0, 0, 0, 0, 0, 0, 0, 0, 0, 0, 0, 0 ],
    [ 0, 0, 0, 0, 0, 4, 0, 0, 0, 0, 0, 0, 12, 0, 0 ],
    [ 0, 0, 0, 0, 0, 0, 0, 0, 0, 0, 0, 0, 0, 0, 0 ],
    [ 0, 0, 0, 0, 0, 0, 0, 9, 0, 0, 0, 0, 10, 0, 0 ],
    [ 0, 0, 0, 0, 0, 0, 0, 10, 0, 0, 0, 0, 0, 0, 0 ],
    [ 0, 0, 0, 0, 0, 0, 0, 0, 0, 0, 0, 0, 0, 0, 0 ],
    [ 0, 0, 0, 0, 0, 0, 0, 0, 0, 0, 0, 0, 0, 0, 0 ],
    [ 0, 0, 0, 0, 0, 0, 0, 0, 0, 0, 0, 8, 0, 0, 0 ],
    [ 10, 0, 0, 0, 0, 0, 0, 0, 0, 0, 0, 0, 0, 0, 0 ],
    [ 0, 0, 0, 0, 0, 0, 0, 0, 0, 3, 0, 0, 0, 0, 0 ],
    [ 0, 0, 0, 0, 0, 0, 0, 0, 0, 0, 0, 0, 0, 0, 0 ],
    [ 0, 0, 0, 0, 0, 0, 0, 0, 0, 0, 0, 0, 0, 0, 0 ],
    [ 9, 0, 0, 0, 0, 0, 0, 0, 0, 0, 0, 0, 0, 0, 0 ],
    [ 0, 0, 0, 0, 0, 0, 0, 0, 0, 0, 12, 0, 0, 0, 0 ],
    [ 0, 0, 0, 0, 0, 0, 0, 0, 0, 0, 9, 0, 0, 0, 0 ],
    [ 0, 0, 0, 0, 0, 0, 0, 0, 0, 0, 0, 0, 0, 0, 0 ],
    [ 0, 16, 16, 0, 0, 0, 0, 0, 0, 0, 0, 0, 0, 0, 0 ],
    [ 0, 0, 0, 0, 0, 0, 0, 0, 0, 0, 0, 0, 0, 0, 0 ],
    [ 0, 0, 0, 17, 0, 0, 0, 0, 0, 0, 0, 0, 0, 0, 0 ],
    [ 0, 0, 0, 17, 0, 0, 0, 0, 19, 0, 0, 0, 0, 0, 0 ],
    [ 0, 0, 0, 0, 0, 0, 0, 0, 0, 0, 0, 0, 0, 0, 0 ],
    [ 0, 0, 0, 0, 0, 0, 0, 0, 0, 0, 0, 0, 0, 0, 0 ],
    [ 0, 0, 0, 0, 0, 0, 0, 0, 0, 0, 0, 0, 0, 0, 0 ],
    [ 0, 0, 0, 0, 0, 0, 0, 0, 0, 0, 0, 0, 0, 0, 0 ],
    [ 0, 0, 0, 0, 0, 17, 0, 0, 0, 0, 0, 0, 0, 0, 0 ]
  ],
  "assetList": [ 2, 1, 2, 3, 4, 4, 4, 4 ],
  "assetPositionList": [ "666, 872", "236, 327", "3894, 851", "4126, 841", "4259, 584", "3873, 7", "1781, 643", "1232, 709" ],
  "levelName": "Test Level"
}